1111111
1PCE001
10000E1
1111111
