1111111
1PCE001
10000P1
1111111
