11111111
100C0E01
1P000C00
11111111
