111111111111111111111
1C0100000000000000001
10010P000000000010001
100100000000000010001
100111000000001110001
1000C0000000001000001
1001110000E000100C001
111111111111111111111
