C000000000000000000
0010P00000000001000
0010000000000001000
0011100000000111000
000C000000000100000
000000000E000000C00
